dbUsername: '${WP_DB_USERNAME}'
dbPassword: '${WP_DB_PASSWORD}'
geoip:
  accountid: '${GEOIP_ACCOUNTID}'
  license: '${GEOIP_LICENSE}'
sqlproxy:
  serviceAccountKey: '${SQLPROXY_KEY}'
exim:
  username: '${EXIM_USERNAME}'
  password: '${EXIM_PASSWORD}'
wp:
  authKey: '${WP_AUTH_KEY}'
  authSalt: '${WP_AUTH_SALT}'
  loggedInKey: '${WP_LOGGED_IN_KEY}'
  loggedInSalt: '${WP_LOGGED_IN_SALT}'
  nonceKey: '${WP_NONCE_KEY}'
  nonceSalt: '${WP_NONCE_SALT}'
  secureAuthKey: '${WP_SECURE_AUTH_KEY}'
  secureAuthSalt: '${WP_SECURE_AUTH_SALT}'
  stateless:
    serviceAccountKey: '${WP_STATELESS_KEY}'
cloudflareApiKey: '${CLOUDFLARE_API_KEY}'
elasticApmSecretToken: '${ELASTIC_APM_SECRET_TOKEN}'
gfLicense: '${GF_LICENSE}'
googleSheetsKey: '${GOOGLE_SHEETS_KEY}'
gpAvatarsKey: '${GOOGLE_PROFILE_AVATARS_KEY}'
planet4ApiKey: '${PLANET4_API_KEY}'
sendgridApiKey: '${SENDGRID_API_KEY}'
sendgridNroApiKey: '${SENDGRID_NRO_API_KEY}'
sentryDsn: '${WP_SENTRY_DSN}'
